#itype,idet,iidx,isid,imid,chL,chU,incre
#itype,idet,iidx,isid,imid,cha,,
#simple,,,,,,,
#BB10
#simple,,,,,,,
#0,0,0,2,3,0,8,1
#0,1,0,2,3,9,15,1
#0,2,0,2,3,16,23,1
#0,3,0,2,3,24,31,1
#0,4,0,2,5,0,8,1
#0,5,0,2,5,9,15,1
##StarkJr,,,,,,,
##pad,,,,,,,
3,0,0,2,7,0,3,1
3,1,0,2,7,4,7,1
3,2,0,2,7,8,11,1
3,3,0,2,7,16,19,1
3,4,0,2,7,20,23,1
3,5,0,2,7,24,27,1
3,6,0,2,9,0,3,1
3,7,0,2,9,4,7,1
3,8,0,2,9,8,11,1
3,9,0,2,9,16,19,1
3,10,0,2,9,20,23,1
3,11,0,2,9,24,27,1
##stripU,,,,,,,
4,0,0,1,1,0,14,2
4,1,0,1,1,16,30,2
4,2,0,1,3,0,14,2
4,3,0,1,3,16,30,2
4,4,0,1,5,0,14,2
4,5,0,1,5,16,30,2
4,6,0,1,7,0,14,2
4,7,0,1,7,16,30,2
4,8,0,1,9,0,14,2
4,9,0,1,9,16,30,2
4,10,0,2,1,0,14,2
4,11,0,2,1,16,30,2
##stripD,,,,,,,
5,0,0,1,1,1,15,2
5,1,0,1,1,17,31,2
5,2,0,1,3,1,15,2
5,3,0,1,3,17,31,2
5,4,0,1,5,1,15,2
5,5,0,1,5,17,31,2
5,6,0,1,7,1,15,2
5,7,0,1,7,17,31,2
5,8,0,1,9,1,15,2
5,9,0,1,9,17,31,2
5,10,0,2,1,1,15,2
5,11,0,2,1,17,31,2
