#itype,idet,iidx,isid,imid,chL,chU,incre
##ASGARD,,,,,,,
2,0,0,3,1,0,7,1
1,0,0,3,1,8,9,1
2,1,0,3,2,0,7,1
1,1,0,3,2,8,9,1
2,2,0,3,3,0,7,1
1,2,0,3,3,8,9,1
2,3,0,3,4,0,7,1
1,3,0,3,4,8,9,1
2,4,0,3,5,0,7,1
1,4,0,3,5,8,9,1
2,5,0,3,6,0,7,1
1,5,0,3,6,8,9,1
2,6,0,3,7,0,7,1
1,6,0,3,7,8,9,1
2,7,0,3,8,0,7,1
1,7,0,3,8,8,9,1
2,8,0,4,1,0,7,1
1,8,0,4,1,8,9,1
2,9,0,4,2,0,7,1
1,9,0,4,2,8,9,1
2,10,0,4,3,0,7,1
1,10,0,4,3,8,9,1
2,11,0,4,4,0,7,1
1,11,0,4,4,8,9,1
2,12,0,4,5,0,7,1
1,12,0,4,5,8,9,1
2,13,0,4,6,0,7,1
1,13,0,4,6,8,9,1
2,14,0,4,7,0,7,1
1,14,0,4,7,8,9,1
2,15,0,4,8,0,7,1
1,15,0,4,8,8,9,1
2,16,0,5,1,0,7,1
1,16,0,5,1,8,9,1
2,17,0,5,2,0,7,1
1,17,0,5,2,8,9,1
2,18,0,5,3,0,7,1
1,18,0,5,3,8,9,1
2,19,0,5,4,0,7,1
1,19,0,5,4,8,9,1
#,,,,,,,
#,,,,,,,
#,,,,,,,
#,,,,,,,
#,,,,,,,
#,,,,,,,
#,,,,,,,
#,,,,,,,
2,20,0,6,1,0,7,1
1,20,0,6,1,8,9,1
2,21,0,6,2,0,7,1
1,21,0,6,2,8,9,1
2,22,0,6,3,0,7,1
1,22,0,6,3,8,9,1
2,23,0,6,4,0,7,1
1,23,0,6,4,8,9,1
2,24,0,6,5,0,7,1
1,24,0,6,5,8,9,1
2,25,0,6,6,0,7,1
1,25,0,6,6,8,9,1
2,26,0,6,7,0,7,1
1,26,0,6,7,8,9,1
2,27,0,6,8,0,7,1
1,27,0,6,8,8,9,1
2,28,0,7,1,0,7,1
1,28,0,7,1,8,9,1
2,29,0,7,2,0,7,1
1,29,0,7,2,8,9,1
2,30,0,7,3,0,7,1
1,30,0,7,3,8,9,1
2,31,0,7,4,0,7,1
1,31,0,7,4,8,9,1
2,32,0,7,5,0,7,1
1,32,0,7,5,8,9,1
2,33,0,7,6,0,7,1
1,33,0,7,6,8,9,1
2,34,0,7,7,0,7,1
1,34,0,7,7,8,9,1
2,35,0,7,8,0,7,1
1,35,0,7,8,8,9,1
2,36,0,8,1,0,7,1
1,36,0,8,1,8,9,1
2,37,0,8,2,0,7,1
1,37,0,8,2,8,9,1
2,38,0,8,3,0,7,1
1,38,0,8,3,8,9,1
2,39,0,8,4,0,7,1
1,39,0,8,4,8,9,1
